###############
#   # # #     #
# ### # ##### #
# # # # #     #
# # # # # # ###
#         #   #
# ### ####### #
#   # #       #
# # # # # # # #
###############
